111111111111111111111
10E0000001000000000P1
100000000100C00000001
100000011100000000001
100000010000011110001
10000000000000C000001
111111111111111111111