111111111111111111111
10E000000100000000001
10000000010000C000001
100000011100000000001
100000010000011110001
100000000000000000001
111111111111111111111