111111111111111111111
10E000000100000000001
100000000100000000001
100C00011100000000001
100000010000011110001
100000000000000000001
111111111111111111111